#################
#X  #         #O#
### # ######  # #
# O # #   O#    #
# # # # #########
# #   # #       #
# ##### #  #### #
#       #  #O   #
##### ###  ######
#               #
#   # ### #######
#   # #        O#
# ##### #########
#O#O          GS#  
#################